-    -  - 
 -   - /\ 
 /\    /\-
 /\       
--------------
^^^^^^^^^^
/ \ - -  -
| |  / \  
 -  -| | -
--------------
.   -  ^  
 ,    /.\ 
 - -  .   
^^^^^^^^^^
------------
   /\     
  /  \/\  
 /   /  \ 
/   /    \